22222222222222222222
2..................2
2..................2
2..22111122..2222112
2..................2
2..................2
2112222..22111111..2
2...............1..2
2...............1..2
2...............1..2
2...............1..2
2112222....112222..2
2..................2
2..................2
22222222222222222222
