22222222222222222222
2........22........2
2........22........2
2..22221122..2222112
2........22........2
2........22........2
2112222..22112222..2
2........22........2
2........22........2
22222222222222222222
2........22........2
2112222..22112222..2
2........22........2
2........22........2
22222222222222222222
