11111111111111111111
1........11........1
1........11........1
1..11110011..1111001
1........11........1
1........11........1
1001111..11001111..1
1........11........1
1........11........1
11111111111111111111
1........11........1
1001111..11001111..1
1........11........1
1........11........1
11111111111111111111