1111111111
1........1
1........1
1..1111001
1........1
1........1
1001111..1
1........1
1........1
1111111111